################
#####..........#
#####.......C.##
#..o..###......#
#..o....#####..#
#..o...........#
#............C.#
#..............#
#......#####...#
######.....C...#
#P.............#
################