################
#...###....#...#
#.....#......C.#
#..........#...#
#..#####...#o###
##C#########o###
#.....C...P.o..#
#....######....#
################
#..............#
#..............#
################