################
#..........#...#
#..........#...#
#.C..#.....C...#
##.#########...#
#.....P#.......#
#.....C........#
##C######.###C##
#.....#..C#....#
#ooo.....C.....#
#oooo.....#....#
################